11111111111
10001000001
10001000001
10001000001
10001000001
10111101111
10100000011
11000011111
11110011101
1000000000011111
1020102002010211
1010101001010001
1010101001010111
1010101001010111
1111101001010111
    110100101011
    110110111011
    110110111011
    110000001001
    111111111111