NO textures/simonkraft/wet_sponge.xpm
SO textures/simonkraft/wet_sponge.xpm


WE textures/simonkraft/wet_sponge.xpm

EA textures/simonkraft/wet_sponge.xpm

F 164,   169,  20


C 153,    204    ,255

   111111111111111111111
   101000001000000000001
   101010101011111110001
   100010100010000010001
   111110101111101011101
   100000101000101000001
   101111101011101111111
   111100001010100000101
110011101011111010111111111
101010101010001010100010101
101110101110101010101010101
100000100000101010001010001
111111111111101011111011101
100000100000101000100010001
101110101110101110101110111
101000101000100000100010101
101011101011111111111010101
100010100010000000000010001
111110101001011101111111111
    101N10000010000011
    111111111111111111